BatchTime, SubmissionTime, SchedulingDelay, TotalDelay, ProcessingDelay, NumberRecords, Scenario
1512015480000 ms, 2017-11-29T22:18:01, 5, 2382, 2377, 0,1_Producer_Count
1512015540000 ms, 2017-11-29T22:19:22, 0, 81900, 81900, 6790,1_Producer_Count
1512015600000 ms, 2017-11-29T22:21:08, 0, 233601, 233601, 11211,1_Producer_Count
1512015660000 ms, 2017-11-29T22:22:10, 171854, 517970, 346116, 15651,1_Producer_Count
1512015720000 ms, 2017-11-29T22:23:55, 412913, 685757, 272844, 14766,1_Producer_Count
1512015780000 ms, 2017-11-29T22:26:07, 553635, 797148, 243513, 24959,1_Producer_Count
1512015840000 ms, 2017-11-29T22:29:00, 624310, 933164, 308854, 31184,1_Producer_Count
1512015900000 ms, 2017-11-29T22:32:18, 734394, 1148630, 414236, 41116,1_Producer_Count
1512015960000 ms, 2017-11-29T22:34:39, 1008417, 1299574, 291157, 29516,1_Producer_Count
1512016020000 ms, 2017-11-29T22:35:06, 1272274, 1298218, 25944, 2583,1_Producer_Count
1512016080000 ms, 2017-11-29T22:35:06, 1297990, 1299337, 1347, 0,1_Producer_Count
1512016140000 ms, 2017-11-29T22:35:06, 1299063, 1300355, 1292, 0,1_Producer_Count
1512016200000 ms, 2017-11-29T22:35:07, 1300075, 1301394, 1319, 0,1_Producer_Count
1512016260000 ms, 2017-11-29T22:35:07, 1301104, 1302383, 1279, 0,1_Producer_Count
1512016320000 ms, 2017-11-29T22:35:07, 1302084, 1303423, 1339, 0,1_Producer_Count
1512016380000 ms, 2017-11-29T22:35:08, 1303153, 1304439, 1286, 0,1_Producer_Count
1512016440000 ms, 2017-11-29T22:35:08, 1304174, 1305514, 1340, 0,1_Producer_Count
1512016500000 ms, 2017-11-29T22:35:08, 1305237, 1306527, 1290, 0,1_Producer_Count
1512016560000 ms, 2017-11-29T22:36:54, 1200899, 1202154, 1255, 0,1_Producer_Count
1512016620000 ms, 2017-11-29T22:37:00, 1195681, 1196958, 1277, 0,1_Producer_Count
1512016680000 ms, 2017-11-29T22:39:04, 1072987, 1074264, 1277, 0,1_Producer_Count
1512016740000 ms, 2017-11-29T22:39:06, 1072286, 1073633, 1347, 0,1_Producer_Count
1512016800000 ms, 2017-11-29T22:41:26, 934090, 935333, 1243, 0,1_Producer_Count
1512016860000 ms, 2017-11-29T22:41:27, 933631, 934935, 1304, 0,1_Producer_Count
1512016920000 ms, 2017-11-29T22:44:06, 776346, 777614, 1268, 0,1_Producer_Count
1512016980000 ms, 2017-11-29T22:44:08, 775348, 776600, 1252, 0,1_Producer_Count
1512017040000 ms, 2017-11-29T22:44:10, 775045, 776310, 1265, 0,1_Producer_Count
1512017100000 ms, 2017-11-29T22:47:05, 601545, 602809, 1264, 0,1_Producer_Count
1512017160000 ms, 2017-11-29T22:47:08, 599307, 600595, 1288, 0,1_Producer_Count
1512017220000 ms, 2017-11-29T22:47:11, 597233, 598455, 1222, 0,1_Producer_Count
1512017280000 ms, 2017-11-29T22:50:41, 388727, 390115, 1388, 0,1_Producer_Count
1512017340000 ms, 2017-11-29T22:50:45, 386547, 387804, 1257, 0,1_Producer_Count
1512017400000 ms, 2017-11-29T22:50:48, 384654, 385903, 1249, 0,1_Producer_Count
1512017460000 ms, 2017-11-29T22:51:00, 373600, 374875, 1275, 0,1_Producer_Count
1512017520000 ms, 2017-11-29T22:53:09, 246050, 247531, 1481, 0,1_Producer_Count
1512017580000 ms, 2017-11-29T22:53:14, 242743, 244019, 1276, 0,1_Producer_Count
1512017640000 ms, 2017-11-29T22:55:37, 100749, 102014, 1265, 0,1_Producer_Count
1512017700000 ms, 2017-11-29T22:55:42, 97630, 98888, 1258, 0,1_Producer_Count
1512017760000 ms, 2017-11-29T22:56:00, 80050, 81297, 1247, 0,1_Producer_Count
1512017820000 ms, 2017-11-29T22:57:00, 21962, 23202, 1240, 0,1_Producer_Count
1512017880000 ms, 2017-11-29T22:58:00, 1, 1265, 1264, 0,1_Producer_Count
1512017940000 ms, 2017-11-29T22:59:00, 0, 1281, 1281, 0,1_Producer_Count
1512018000000 ms, 2017-11-29T23:00:00, 1, 1274, 1273, 0,1_Producer_Count
1512018060000 ms, 2017-11-29T23:01:00, 0, 1278, 1278, 0,1_Producer_Count
1512018120000 ms, 2017-11-29T23:02:00, 0, 1260, 1260, 0,1_Producer_Count
1512018180000 ms, 2017-11-29T23:03:00, 1, 1281, 1280, 0,1_Producer_Count
1512018240000 ms, 2017-11-29T23:04:00, 1, 1265, 1264, 0,1_Producer_Count
1512018300000 ms, 2017-11-29T23:05:00, 0, 1267, 1267, 0,1_Producer_Count
1512018360000 ms, 2017-11-29T23:06:00, 1, 1279, 1278, 0,1_Producer_Count
1512018420000 ms, 2017-11-29T23:07:00, 1, 1265, 1264, 0,1_Producer_Count
1512018480000 ms, 2017-11-29T23:08:00, 1, 1280, 1279, 0,1_Producer_Count
1512018540000 ms, 2017-11-29T23:09:00, 1, 1272, 1271, 0,1_Producer_Count
1512018600000 ms, 2017-11-29T23:10:00, 1, 1303, 1302, 0,1_Producer_Count
1512018660000 ms, 2017-11-29T23:11:00, 1, 1292, 1291, 0,1_Producer_Count
1512018720000 ms, 2017-11-29T23:12:00, 1, 1285, 1284, 0,1_Producer_Count
1512018780000 ms, 2017-11-29T23:13:00, 1, 1278, 1277, 0,1_Producer_Count
1512018840000 ms, 2017-11-29T23:14:00, 1, 1306, 1305, 0,1_Producer_Count
1512018900000 ms, 2017-11-29T23:15:00, 1, 1271, 1270, 0,1_Producer_Count
1512018960000 ms, 2017-11-29T23:16:00, 0, 1263, 1263, 0,1_Producer_Count
1512019020000 ms, 2017-11-29T23:17:00, 0, 1285, 1285, 0,1_Producer_Count
1512019080000 ms, 2017-11-29T23:18:00, 1, 1256, 1255, 0,1_Producer_Count
1512019140000 ms, 2017-11-29T23:19:00, 0, 1265, 1265, 0,1_Producer_Count
1512019200000 ms, 2017-11-29T23:20:00, 2, 1272, 1270, 0,1_Producer_Count
1512019260000 ms, 2017-11-29T23:21:00, 1, 1279, 1278, 0,1_Producer_Count
1512019320000 ms, 2017-11-29T23:22:00, 1, 1282, 1281, 0,1_Producer_Count
1512019380000 ms, 2017-11-29T23:23:00, 1, 1262, 1261, 0,1_Producer_Count
1512019440000 ms, 2017-11-29T23:24:00, 1, 1283, 1282, 0,1_Producer_Count
1512019500000 ms, 2017-11-29T23:25:00, 1, 1283, 1282, 0,1_Producer_Count
1512019560000 ms, 2017-11-29T23:26:00, 1, 1260, 1259, 0,1_Producer_Count
1512019620000 ms, 2017-11-29T23:27:00, 1, 1241, 1240, 0,1_Producer_Count
1512019680000 ms, 2017-11-29T23:28:00, 1, 1262, 1261, 0,1_Producer_Count
1512019740000 ms, 2017-11-29T23:29:00, 1, 1282, 1281, 0,1_Producer_Count
1512019800000 ms, 2017-11-29T23:30:00, 1, 1275, 1274, 0,1_Producer_Count
1512019860000 ms, 2017-11-29T23:31:00, 1, 1273, 1272, 0,1_Producer_Count
1512019920000 ms, 2017-11-29T23:32:00, 1, 1255, 1254, 0,1_Producer_Count
1512019980000 ms, 2017-11-29T23:33:00, 1, 1269, 1268, 0,1_Producer_Count
1512020040000 ms, 2017-11-29T23:34:00, 0, 1263, 1263, 0,1_Producer_Count
1512020100000 ms, 2017-11-29T23:35:00, 1, 1251, 1250, 0,1_Producer_Count
1512020160000 ms, 2017-11-29T23:36:00, 0, 1261, 1261, 0,1_Producer_Count
1512020220000 ms, 2017-11-29T23:37:00, 1, 1273, 1272, 0,1_Producer_Count
1512020280000 ms, 2017-11-29T23:38:00, 0, 1263, 1263, 0,1_Producer_Count
1512020340000 ms, 2017-11-29T23:39:00, 0, 1258, 1258, 0,1_Producer_Count
1512020400000 ms, 2017-11-29T23:40:00, 1, 1247, 1246, 0,1_Producer_Count
1512020460000 ms, 2017-11-29T23:41:00, 0, 1288, 1288, 0,1_Producer_Count
1512020520000 ms, 2017-11-29T23:42:00, 1, 1244, 1243, 0,1_Producer_Count
1512020580000 ms, 2017-11-29T23:43:00, 2, 1275, 1273, 0,1_Producer_Count
1512020640000 ms, 2017-11-29T23:44:00, 1, 1276, 1275, 0,1_Producer_Count
1512020700000 ms, 2017-11-29T23:45:00, 1, 1260, 1259, 0,1_Producer_Count
