BatchTime, SubmissionTime, SchedulingDelay, TotalDelay, ProcessingDelay, NumberRecords, Scenario
1512605100000 ms, 2017-12-06T18:05:02, 5, 2827, 2822, 0,1_Producer_Count
1512605160000 ms, 2017-12-06T18:06:00, 1, 1978, 1977, 0,1_Producer_Count
1512605220000 ms, 2017-12-06T18:07:13, 1, 36389, 36388, 11678,1_Producer_Count
1512605280000 ms, 2017-12-06T18:08:14, 1, 44247, 44246, 14099,1_Producer_Count
1512605340000 ms, 2017-12-06T18:09:16, 0, 57613, 57613, 17131,1_Producer_Count
1512605400000 ms, 2017-12-06T18:10:20, 1, 61963, 61962, 18228,1_Producer_Count
1512605460000 ms, 2017-12-06T18:11:26, 0, 58283, 58283, 17495,1_Producer_Count
1512605520000 ms, 2017-12-06T18:12:29, 1, 60124, 60123, 17476,1_Producer_Count
1512605580000 ms, 2017-12-06T18:13:32, 0, 59995, 59995, 17889,1_Producer_Count
1512605640000 ms, 2017-12-06T18:14:38, 0, 61380, 61380, 16906,1_Producer_Count
1512605700000 ms, 2017-12-06T18:15:19, 20387, 80391, 60004, 18039,1_Producer_Count
1512605760000 ms, 2017-12-06T18:16:24, 16011, 72246, 56235, 16314,1_Producer_Count
1512605820000 ms, 2017-12-06T18:17:23, 12383, 62859, 50476, 16440,1_Producer_Count
1512605880000 ms, 2017-12-06T18:18:37, 0, 56076, 56076, 16358,1_Producer_Count
1512605940000 ms, 2017-12-06T18:19:17, 15934, 48177, 32243, 10089,1_Producer_Count
1512606000000 ms, 2017-12-06T18:20:05, 0, 13965, 13965, 4731,1_Producer_Count
1512606060000 ms, 2017-12-06T18:21:04, 0, 14254, 14254, 4755,1_Producer_Count
1512606120000 ms, 2017-12-06T18:22:04, 0, 13114, 13114, 4189,1_Producer_Count
1512606180000 ms, 2017-12-06T18:23:00, 0, 2652, 2652, 403,1_Producer_Count
1512606240000 ms, 2017-12-06T18:24:00, 1, 1522, 1521, 0,1_Producer_Count
1512606300000 ms, 2017-12-06T18:25:00, 1, 1511, 1510, 0,1_Producer_Count
1512606360000 ms, 2017-12-06T18:26:00, 2, 1520, 1518, 0,1_Producer_Count
1512606420000 ms, 2017-12-06T18:27:00, 1, 1504, 1503, 0,1_Producer_Count
1512606480000 ms, 2017-12-06T18:28:00, 2, 1500, 1498, 0,1_Producer_Count
1512606540000 ms, 2017-12-06T18:29:00, 1, 1507, 1506, 0,1_Producer_Count
1512606600000 ms, 2017-12-06T18:30:00, 1, 1516, 1515, 0,1_Producer_Count
1512606660000 ms, 2017-12-06T18:31:00, 1, 1499, 1498, 0,1_Producer_Count
1512606720000 ms, 2017-12-06T18:32:00, 1, 1497, 1496, 0,1_Producer_Count
1512606780000 ms, 2017-12-06T18:33:00, 1, 1516, 1515, 0,1_Producer_Count
1512606840000 ms, 2017-12-06T18:34:00, 1, 1525, 1524, 0,1_Producer_Count
1512606900000 ms, 2017-12-06T18:35:00, 1, 1519, 1518, 0,1_Producer_Count
1512606960000 ms, 2017-12-06T18:36:00, 1, 1526, 1525, 0,1_Producer_Count
1512607020000 ms, 2017-12-06T18:37:00, 1, 1513, 1512, 0,1_Producer_Count
1512607080000 ms, 2017-12-06T18:38:00, 2, 1517, 1515, 0,1_Producer_Count
1512607140000 ms, 2017-12-06T18:39:00, 0, 1501, 1501, 0,1_Producer_Count
1512607200000 ms, 2017-12-06T18:40:00, 1, 1587, 1586, 0,1_Producer_Count
1512607260000 ms, 2017-12-06T18:41:00, 1, 1505, 1504, 0,1_Producer_Count
1512607320000 ms, 2017-12-06T18:42:00, 1, 1509, 1508, 0,1_Producer_Count
1512607380000 ms, 2017-12-06T18:43:00, 1, 1522, 1521, 0,1_Producer_Count
1512607440000 ms, 2017-12-06T18:44:00, 0, 1505, 1505, 0,1_Producer_Count
1512607500000 ms, 2017-12-06T18:45:00, 1, 1507, 1506, 0,1_Producer_Count
1512607560000 ms, 2017-12-06T18:46:00, 1, 1508, 1507, 0,1_Producer_Count
1512607620000 ms, 2017-12-06T18:47:00, 1, 1528, 1527, 0,1_Producer_Count
1512607680000 ms, 2017-12-06T18:48:00, 1, 1513, 1512, 0,1_Producer_Count
1512607740000 ms, 2017-12-06T18:49:00, 1, 1504, 1503, 0,1_Producer_Count
1512607800000 ms, 2017-12-06T18:50:00, 1, 1615, 1614, 0,1_Producer_Count
1512607860000 ms, 2017-12-06T18:51:00, 1, 1528, 1527, 0,1_Producer_Count
1512607920000 ms, 2017-12-06T18:52:00, 1, 1502, 1501, 0,1_Producer_Count
1512607980000 ms, 2017-12-06T18:53:00, 1, 1510, 1509, 0,1_Producer_Count
1512608040000 ms, 2017-12-06T18:54:00, 0, 1504, 1504, 0,1_Producer_Count
1512608100000 ms, 2017-12-06T18:55:00, 1, 1500, 1499, 0,1_Producer_Count
1512608160000 ms, 2017-12-06T18:56:00, 0, 1498, 1498, 0,1_Producer_Count
1512608220000 ms, 2017-12-06T18:57:00, 0, 1568, 1568, 0,1_Producer_Count
1512608280000 ms, 2017-12-06T18:58:00, 0, 1531, 1531, 0,1_Producer_Count
1512608340000 ms, 2017-12-06T18:59:00, 1, 1497, 1496, 0,1_Producer_Count
1512608400000 ms, 2017-12-06T19:00:00, 0, 1522, 1522, 0,1_Producer_Count
1512608460000 ms, 2017-12-06T19:01:00, 1, 1511, 1510, 0,1_Producer_Count
1512608520000 ms, 2017-12-06T19:02:00, 1, 1497, 1496, 0,1_Producer_Count
1512608580000 ms, 2017-12-06T19:03:00, 1, 1505, 1504, 0,1_Producer_Count
1512608640000 ms, 2017-12-06T19:04:00, 1, 1504, 1503, 0,1_Producer_Count
1512608700000 ms, 2017-12-06T19:05:00, 0, 1540, 1540, 0,1_Producer_Count
1512608760000 ms, 2017-12-06T19:06:00, 1, 1515, 1514, 0,1_Producer_Count
1512608820000 ms, 2017-12-06T19:07:00, 1, 1542, 1541, 0,1_Producer_Count
1512608880000 ms, 2017-12-06T19:08:00, 0, 1500, 1500, 0,1_Producer_Count
1512608940000 ms, 2017-12-06T19:09:00, 1, 1492, 1491, 0,1_Producer_Count
1512609000000 ms, 2017-12-06T19:10:00, 0, 1486, 1486, 0,1_Producer_Count
1512609060000 ms, 2017-12-06T19:11:00, 0, 1490, 1490, 0,1_Producer_Count
1512609120000 ms, 2017-12-06T19:12:00, 1, 1506, 1505, 0,1_Producer_Count
1512609180000 ms, 2017-12-06T19:13:00, 1, 1531, 1530, 0,1_Producer_Count
1512609240000 ms, 2017-12-06T19:14:00, 0, 1519, 1519, 0,1_Producer_Count
1512609300000 ms, 2017-12-06T19:15:00, 1, 1543, 1542, 0,1_Producer_Count
1512609360000 ms, 2017-12-06T19:16:00, 1, 1480, 1479, 0,1_Producer_Count
1512609420000 ms, 2017-12-06T19:17:00, 1, 1551, 1550, 0,1_Producer_Count
1512609480000 ms, 2017-12-06T19:18:00, 1, 1493, 1492, 0,1_Producer_Count
1512609540000 ms, 2017-12-06T19:19:00, 1, 1485, 1484, 0,1_Producer_Count
1512609600000 ms, 2017-12-06T19:20:00, 1, 1496, 1495, 0,1_Producer_Count
1512609660000 ms, 2017-12-06T19:21:00, 1, 1484, 1483, 0,1_Producer_Count
1512609720000 ms, 2017-12-06T19:22:00, 1, 1514, 1513, 0,1_Producer_Count
1512609780000 ms, 2017-12-06T19:23:00, 1, 1507, 1506, 0,1_Producer_Count
1512609840000 ms, 2017-12-06T19:24:00, 0, 1518, 1518, 0,1_Producer_Count
1512609900000 ms, 2017-12-06T19:25:00, 1, 1508, 1507, 0,1_Producer_Count
1512609960000 ms, 2017-12-06T19:26:00, 0, 1496, 1496, 0,1_Producer_Count
1512610020000 ms, 2017-12-06T19:27:00, 0, 1486, 1486, 0,1_Producer_Count
1512610080000 ms, 2017-12-06T19:28:00, 1, 1512, 1511, 0,1_Producer_Count
1512610140000 ms, 2017-12-06T19:29:00, 1, 1495, 1494, 0,1_Producer_Count
1512610200000 ms, 2017-12-06T19:30:00, 1, 1525, 1524, 0,1_Producer_Count
1512610260000 ms, 2017-12-06T19:31:00, 1, 1520, 1519, 0,1_Producer_Count
1512610320000 ms, 2017-12-06T19:32:00, 0, 1502, 1502, 0,1_Producer_Count
1512610380000 ms, 2017-12-06T19:33:00, 1, 1507, 1506, 0,1_Producer_Count
1512610440000 ms, 2017-12-06T19:34:00, 1, 1509, 1508, 0,1_Producer_Count
1512610500000 ms, 2017-12-06T19:35:00, 0, 1499, 1499, 0,1_Producer_Count
1512610560000 ms, 2017-12-06T19:36:00, 0, 1500, 1500, 0,1_Producer_Count
1512610620000 ms, 2017-12-06T19:37:00, 0, 1489, 1489, 0,1_Producer_Count
1512610680000 ms, 2017-12-06T19:38:00, 0, 1499, 1499, 0,1_Producer_Count
1512610740000 ms, 2017-12-06T19:39:00, 1, 1481, 1480, 0,1_Producer_Count
1512610800000 ms, 2017-12-06T19:40:00, 1, 1483, 1482, 0,1_Producer_Count
1512610860000 ms, 2017-12-06T19:41:00, 1, 1502, 1501, 0,1_Producer_Count
1512610920000 ms, 2017-12-06T19:42:00, 1, 1516, 1515, 0,1_Producer_Count
1512610980000 ms, 2017-12-06T19:43:00, 1, 1503, 1502, 0,1_Producer_Count
1512611040000 ms, 2017-12-06T19:44:00, 0, 1554, 1554, 0,1_Producer_Count
1512611100000 ms, 2017-12-06T19:45:00, 0, 1528, 1528, 0,1_Producer_Count
1512611160000 ms, 2017-12-06T19:46:00, 1, 1506, 1505, 0,1_Producer_Count
