BatchTime, SubmissionTime, SchedulingDelay, TotalDelay, ProcessingDelay, NumberRecords, Scenario,Application,Centers
1512948900000 ms, 2017-12-10T17:35:02, 5, 3019, 3014, 0,10P-1B-4C,kmeans,10
1512948960000 ms, 2017-12-10T17:36:00, 0, 2008, 2008, 0,10P-1B-4C,kmeans,10
1512949020000 ms, 2017-12-10T17:37:17, 1, 59119, 59118, 16888,10P-1B-4C,kmeans,10
1512949080000 ms, 2017-12-10T17:38:22, 0, 64671, 64671, 19454,10P-1B-4C,kmeans,10
1512949140000 ms, 2017-12-10T17:39:32, 0, 61884, 61884, 19715,10P-1B-4C,kmeans,10
1512949200000 ms, 2017-12-10T17:40:43, 1, 58642, 58641, 19596,10P-1B-4C,kmeans,10
1512949260000 ms, 2017-12-10T17:41:10, 32282, 46553, 14271, 4347,10P-1B-4C,kmeans,10
1512949320000 ms, 2017-12-10T17:42:00, 0, 1510, 1510, 0,10P-1B-4C,kmeans,10
1512949380000 ms, 2017-12-10T17:43:00, 0, 2095, 2095, 239,10P-1B-4C,kmeans,10
1512949440000 ms, 2017-12-10T17:44:19, 0, 67635, 67635, 19123,10P-1B-4C,kmeans,10
1512949500000 ms, 2017-12-10T17:45:31, 1, 65364, 65363, 19993,10P-1B-4C,kmeans,10
1512949560000 ms, 2017-12-10T17:46:42, 0, 64740, 64740, 20044,10P-1B-4C,kmeans,10
1512949620000 ms, 2017-12-10T17:47:33, 13885, 64432, 50547, 17662,10P-1B-4C,kmeans,10
1512949680000 ms, 2017-12-10T17:48:06, 31406, 37244, 5838, 1734,10P-1B-4C,kmeans,10
1512949740000 ms, 2017-12-10T17:49:01, 0, 4350, 4350, 1205,10P-1B-4C,kmeans,10
1512949800000 ms, 2017-12-10T17:50:00, 1, 1525, 1524, 0,10P-1B-4C,kmeans,10
1512949860000 ms, 2017-12-10T17:51:00, 0, 1523, 1523, 0,10P-1B-4C,kmeans,10
1512949920000 ms, 2017-12-10T17:52:15, 2, 50782, 50780, 15247,10P-1B-4C,kmeans,10
1512949980000 ms, 2017-12-10T17:53:19, 2, 67270, 67268, 20307,10P-1B-4C,kmeans,10
1512950040000 ms, 2017-12-10T17:54:32, 2, 65071, 65069, 20474,10P-1B-4C,kmeans,10
1512950100000 ms, 2017-12-10T17:55:45, 0, 60934, 60934, 20759,10P-1B-4C,kmeans,10
1512950160000 ms, 2017-12-10T17:56:11, 35352, 47224, 11872, 3213,10P-1B-4C,kmeans,10
1512950220000 ms, 2017-12-10T17:57:00, 1, 1497, 1496, 0,10P-1B-4C,kmeans,10
1512950280000 ms, 2017-12-10T17:58:07, 0, 19655, 19655, 6227,10P-1B-4C,kmeans,10
1512950340000 ms, 2017-12-10T17:59:19, 1, 69025, 69024, 21082,10P-1B-4C,kmeans,10
1512950400000 ms, 2017-12-10T18:00:34, 2, 70754, 70752, 20729,10P-1B-4C,kmeans,10
1512950460000 ms, 2017-12-10T18:01:30, 14548, 75681, 61133, 19471,10P-1B-4C,kmeans,10
1512950520000 ms, 2017-12-10T18:02:25, 20502, 56773, 36271, 12491,10P-1B-4C,kmeans,10
1512950580000 ms, 2017-12-10T18:03:00, 22244, 23734, 1490, 0,10P-1B-4C,kmeans,10
1512950640000 ms, 2017-12-10T18:04:00, 1, 1504, 1503, 0,10P-1B-4C,kmeans,10
1512950700000 ms, 2017-12-10T18:05:16, 0, 56897, 56897, 16560,10P-1B-4C,kmeans,10
1512950760000 ms, 2017-12-10T18:06:21, 0, 71153, 71153, 21041,10P-1B-4C,kmeans,10
1512950820000 ms, 2017-12-10T18:07:37, 1, 70081, 70080, 20542,10P-1B-4C,kmeans,10
1512950880000 ms, 2017-12-10T18:08:33, 13544, 73611, 60067, 20251,10P-1B-4C,kmeans,10
1512950940000 ms, 2017-12-10T18:09:09, 38223, 44449, 6226, 1606,10P-1B-4C,kmeans,10
1512951000000 ms, 2017-12-10T18:10:00, 0, 1503, 1503, 0,10P-1B-4C,kmeans,10
1512951060000 ms, 2017-12-10T18:11:00, 1, 1844, 1843, 170,10P-1B-4C,kmeans,10
1512951120000 ms, 2017-12-10T18:12:20, 0, 69987, 69987, 20543,10P-1B-4C,kmeans,10
1512951180000 ms, 2017-12-10T18:13:36, 1, 70657, 70656, 20428,10P-1B-4C,kmeans,10
1512951240000 ms, 2017-12-10T18:14:30, 16558, 85109, 68551, 20791,10P-1B-4C,kmeans,10
1512951300000 ms, 2017-12-10T18:15:37, 18247, 69846, 51599, 17570,10P-1B-4C,kmeans,10
1512951360000 ms, 2017-12-10T18:16:11, 36279, 38723, 2444, 498,10P-1B-4C,kmeans,10
1512951420000 ms, 2017-12-10T18:17:00, 0, 1496, 1496, 0,10P-1B-4C,kmeans,10
1512951480000 ms, 2017-12-10T18:18:00, 0, 1499, 1499, 0,10P-1B-4C,kmeans,10
1512951540000 ms, 2017-12-10T18:19:00, 1, 1495, 1494, 0,10P-1B-4C,kmeans,10
1512951600000 ms, 2017-12-10T18:20:00, 0, 1492, 1492, 0,10P-1B-4C,kmeans,10
1512951660000 ms, 2017-12-10T18:21:00, 1, 1482, 1481, 0,10P-1B-4C,kmeans,10
1512951720000 ms, 2017-12-10T18:22:00, 1, 1492, 1491, 0,10P-1B-4C,kmeans,10
1512951780000 ms, 2017-12-10T18:23:00, 1, 1499, 1498, 0,10P-1B-4C,kmeans,10
1512951840000 ms, 2017-12-10T18:24:00, 1, 1535, 1534, 0,10P-1B-4C,kmeans,10
1512951900000 ms, 2017-12-10T18:25:00, 1, 1471, 1470, 0,10P-1B-4C,kmeans,10
1512951960000 ms, 2017-12-10T18:26:00, 1, 1498, 1497, 0,10P-1B-4C,kmeans,10
1512952020000 ms, 2017-12-10T18:27:00, 0, 1495, 1495, 0,10P-1B-4C,kmeans,10
1512952080000 ms, 2017-12-10T18:28:00, 1, 1578, 1577, 0,10P-1B-4C,kmeans,10
1512952140000 ms, 2017-12-10T18:29:00, 1, 1499, 1498, 0,10P-1B-4C,kmeans,10
1512952200000 ms, 2017-12-10T18:30:00, 1, 1488, 1487, 0,10P-1B-4C,kmeans,10
1512952260000 ms, 2017-12-10T18:31:00, 1, 1506, 1505, 0,10P-1B-4C,kmeans,10
1512952320000 ms, 2017-12-10T18:32:00, 1, 1518, 1517, 0,10P-1B-4C,kmeans,10
1512952380000 ms, 2017-12-10T18:33:00, 1, 1501, 1500, 0,10P-1B-4C,kmeans,10
1512952440000 ms, 2017-12-10T18:34:00, 1, 1505, 1504, 0,10P-1B-4C,kmeans,10
1512952500000 ms, 2017-12-10T18:35:00, 0, 1494, 1494, 0,10P-1B-4C,kmeans,10
1512952560000 ms, 2017-12-10T18:36:00, 1, 1528, 1527, 0,10P-1B-4C,kmeans,10
1512952620000 ms, 2017-12-10T18:37:00, 1, 1500, 1499, 0,10P-1B-4C,kmeans,10
1512952680000 ms, 2017-12-10T18:38:00, 1, 1491, 1490, 0,10P-1B-4C,kmeans,10
1512952740000 ms, 2017-12-10T18:39:00, 0, 1491, 1491, 0,10P-1B-4C,kmeans,10
1512952800000 ms, 2017-12-10T18:40:00, 0, 1497, 1497, 0,10P-1B-4C,kmeans,10
1512952860000 ms, 2017-12-10T18:41:00, 1, 1503, 1502, 0,10P-1B-4C,kmeans,10
1512952920000 ms, 2017-12-10T18:42:00, 1, 1499, 1498, 0,10P-1B-4C,kmeans,10
1512952980000 ms, 2017-12-10T18:43:00, 1, 1493, 1492, 0,10P-1B-4C,kmeans,10
1512953040000 ms, 2017-12-10T18:44:00, 1, 1483, 1482, 0,10P-1B-4C,kmeans,10
1512953100000 ms, 2017-12-10T18:45:00, 1, 1494, 1493, 0,10P-1B-4C,kmeans,10
1512953160000 ms, 2017-12-10T18:46:00, 1, 1504, 1503, 0,10P-1B-4C,kmeans,10
1512953220000 ms, 2017-12-10T18:47:00, 1, 1516, 1515, 0,10P-1B-4C,kmeans,10
1512953280000 ms, 2017-12-10T18:48:00, 1, 1515, 1514, 0,10P-1B-4C,kmeans,10
1512953340000 ms, 2017-12-10T18:49:00, 1, 1497, 1496, 0,10P-1B-4C,kmeans,10
1512953400000 ms, 2017-12-10T18:50:00, 1, 1498, 1497, 0,10P-1B-4C,kmeans,10
1512953460000 ms, 2017-12-10T18:51:00, 0, 1490, 1490, 0,10P-1B-4C,kmeans,10
1512953520000 ms, 2017-12-10T18:52:00, 1, 1487, 1486, 0,10P-1B-4C,kmeans,10
1512953580000 ms, 2017-12-10T18:53:00, 1, 1518, 1517, 0,10P-1B-4C,kmeans,10
1512953640000 ms, 2017-12-10T18:54:00, 1, 1481, 1480, 0,10P-1B-4C,kmeans,10
1512953700000 ms, 2017-12-10T18:55:00, 0, 1485, 1485, 0,10P-1B-4C,kmeans,10
1512953760000 ms, 2017-12-10T18:56:00, 1, 1493, 1492, 0,10P-1B-4C,kmeans,10
1512953820000 ms, 2017-12-10T18:57:00, 0, 1510, 1510, 0,10P-1B-4C,kmeans,10
1512953880000 ms, 2017-12-10T18:58:00, 0, 1499, 1499, 0,10P-1B-4C,kmeans,10
1512953940000 ms, 2017-12-10T18:59:00, 0, 1535, 1535, 0,10P-1B-4C,kmeans,10
1512954000000 ms, 2017-12-10T19:00:00, 6, 1496, 1490, 0,10P-1B-4C,kmeans,10
