BatchTime, SubmissionTime, SchedulingDelay, TotalDelay, ProcessingDelay, NumberRecords, Scenario,Application,Centers
1512933720000 ms, 2017-12-10T13:22:02, 4, 2335, 2331, 0,6P-1B-2C,kmeans,10
1512933780000 ms, 2017-12-10T13:23:18, 1, 65537, 65536, 10016,6P-1B-2C,kmeans,10
1512933840000 ms, 2017-12-10T13:24:26, 0, 58229, 58229, 9464,6P-1B-2C,kmeans,10
1512933900000 ms, 2017-12-10T13:25:31, 1, 54624, 54623, 9388,6P-1B-2C,kmeans,10
1512933960000 ms, 2017-12-10T13:26:29, 1, 32474, 32473, 5975,6P-1B-2C,kmeans,10
1512934020000 ms, 2017-12-10T13:27:02, 1, 7143, 7142, 1157,6P-1B-2C,kmeans,10
1512934080000 ms, 2017-12-10T13:28:00, 1, 1371, 1370, 0,6P-1B-2C,kmeans,10
1512934140000 ms, 2017-12-10T13:29:00, 0, 1375, 1375, 0,6P-1B-2C,kmeans,10
1512934200000 ms, 2017-12-10T13:30:17, 0, 65347, 65347, 10350,6P-1B-2C,kmeans,10
1512934260000 ms, 2017-12-10T13:31:29, 0, 62490, 62490, 10754,6P-1B-2C,kmeans,10
1512934320000 ms, 2017-12-10T13:32:41, 1, 59632, 59631, 10569,6P-1B-2C,kmeans,10
1512934380000 ms, 2017-12-10T13:33:16, 24364, 48099, 23735, 4273,6P-1B-2C,kmeans,10
1512934440000 ms, 2017-12-10T13:34:00, 4005, 5382, 1377, 54,6P-1B-2C,kmeans,10
1512934500000 ms, 2017-12-10T13:35:00, 0, 1318, 1318, 0,6P-1B-2C,kmeans,10
1512934560000 ms, 2017-12-10T13:36:09, 0, 30674, 30674, 5588,6P-1B-2C,kmeans,10
1512934620000 ms, 2017-12-10T13:37:18, 1, 67041, 67040, 11165,6P-1B-2C,kmeans,10
1512934680000 ms, 2017-12-10T13:38:35, 0, 68768, 68768, 11018,6P-1B-2C,kmeans,10
1512934740000 ms, 2017-12-10T13:39:24, 19903, 65035, 45132, 8229,6P-1B-2C,kmeans,10
1512934800000 ms, 2017-12-10T13:40:00, 28813, 30137, 1324, 0,6P-1B-2C,kmeans,10
1512934860000 ms, 2017-12-10T13:41:00, 1, 1377, 1376, 0,6P-1B-2C,kmeans,10
1512934920000 ms, 2017-12-10T13:42:00, 1, 1344, 1343, 0,6P-1B-2C,kmeans,10
1512934980000 ms, 2017-12-10T13:43:00, 0, 1349, 1349, 0,6P-1B-2C,kmeans,10
1512935040000 ms, 2017-12-10T13:44:00, 1, 1294, 1293, 0,6P-1B-2C,kmeans,10
1512935100000 ms, 2017-12-10T13:45:00, 1, 1301, 1300, 0,6P-1B-2C,kmeans,10
1512935160000 ms, 2017-12-10T13:46:00, 1, 1308, 1307, 0,6P-1B-2C,kmeans,10
1512935220000 ms, 2017-12-10T13:47:00, 1, 1326, 1325, 0,6P-1B-2C,kmeans,10
1512935280000 ms, 2017-12-10T13:48:00, 0, 1321, 1321, 0,6P-1B-2C,kmeans,10
1512935340000 ms, 2017-12-10T13:49:00, 0, 1317, 1317, 0,6P-1B-2C,kmeans,10
1512935400000 ms, 2017-12-10T13:50:00, 1, 1346, 1345, 0,6P-1B-2C,kmeans,10
1512935460000 ms, 2017-12-10T13:51:00, 1, 1336, 1335, 0,6P-1B-2C,kmeans,10
1512935520000 ms, 2017-12-10T13:52:00, 1, 1342, 1341, 0,6P-1B-2C,kmeans,10
1512935580000 ms, 2017-12-10T13:53:00, 0, 1327, 1327, 0,6P-1B-2C,kmeans,10
1512935640000 ms, 2017-12-10T13:54:00, 1, 1291, 1290, 0,6P-1B-2C,kmeans,10
1512935700000 ms, 2017-12-10T13:55:00, 1, 1325, 1324, 0,6P-1B-2C,kmeans,10
1512935760000 ms, 2017-12-10T13:56:00, 0, 1317, 1317, 0,6P-1B-2C,kmeans,10
1512935820000 ms, 2017-12-10T13:57:00, 1, 1316, 1315, 0,6P-1B-2C,kmeans,10
1512935880000 ms, 2017-12-10T13:58:00, 1, 1338, 1337, 0,6P-1B-2C,kmeans,10
1512935940000 ms, 2017-12-10T13:59:00, 1, 1312, 1311, 0,6P-1B-2C,kmeans,10
1512936000000 ms, 2017-12-10T14:00:00, 1, 1309, 1308, 0,6P-1B-2C,kmeans,10
1512936060000 ms, 2017-12-10T14:01:00, 1, 1309, 1308, 0,6P-1B-2C,kmeans,10
1512936120000 ms, 2017-12-10T14:02:00, 1, 1326, 1325, 0,3P-1B-2C,kmeans,10
1512936180000 ms, 2017-12-10T14:03:00, 1, 1303, 1302, 0,3P-1B-2C,kmeans,10
1512936240000 ms, 2017-12-10T14:04:00, 1, 1311, 1310, 0,3P-1B-2C,kmeans,10
1512936300000 ms, 2017-12-10T14:05:00, 1, 1284, 1283, 0,3P-1B-2C,kmeans,10
1512936360000 ms, 2017-12-10T14:06:00, 1, 1319, 1318, 0,3P-1B-2C,kmeans,10
1512936420000 ms, 2017-12-10T14:07:00, 2, 1325, 1323, 0,3P-1B-2C,kmeans,10
1512936480000 ms, 2017-12-10T14:08:00, 1, 1311, 1310, 0,3P-1B-2C,kmeans,10
1512936540000 ms, 2017-12-10T14:09:00, 1, 1287, 1286, 0,3P-1B-1C,kmeans,10
1512936600000 ms, 2017-12-10T14:10:00, 1, 1333, 1332, 0,3P-1B-1C,kmeans,10
1512936660000 ms, 2017-12-10T14:11:00, 1, 1305, 1304, 0,3P-1B-1C,kmeans,10
1512936720000 ms, 2017-12-10T14:12:00, 1, 1309, 1308, 0,3P-1B-1C,kmeans,10
1512936780000 ms, 2017-12-10T14:13:00, 1, 1318, 1317, 0,3P-1B-1C,kmeans,10
1512936840000 ms, 2017-12-10T14:14:00, 1, 1332, 1331, 0,3P-1B-1C,kmeans,10
1512936900000 ms, 2017-12-10T14:15:00, 2, 1299, 1297, 0,3P-1B-1C,kmeans,10
