BatchTime, SubmissionTime, SchedulingDelay, ProcessingDelay, TotalDelay, NumberRecords, Scenario
1529209920000 ms, 2018-06-16T23:32:00, 4, 121448, 121452, 48,light-sirt-1-1-1-100
1529209980000 ms, 2018-06-16T23:33:00, 61507, 60749, 122256, 24,light-sirt-1-1-1-100
1529210040000 ms, 2018-06-16T23:34:00, 62258, 60918, 123176, 24,light-sirt-1-1-1-100
1529210100000 ms, 2018-06-16T23:35:00, 63177, 60306, 123483, 24,light-sirt-1-1-1-100
1529210400000 ms, 2018-06-16T23:40:00, 4, 63261, 63265, 24,light-sirt-1-1-2-100
1529210460000 ms, 2018-06-16T23:41:00, 3317, 121200, 124517, 48,light-sirt-1-1-2-100
1529210520000 ms, 2018-06-16T23:42:00, 64519, 60710, 125229, 24,light-sirt-1-1-2-100
1529210580000 ms, 2018-06-16T23:43:00, 65230, 60961, 126191, 24,light-sirt-1-1-2-100
1529210880000 ms, 2018-06-16T23:48:00, 5, 62514, 62519, 24,light-sirt-1-1-4-100
1529210940000 ms, 2018-06-16T23:49:00, 2569, 120799, 123368, 48,light-sirt-1-1-4-100
1529211000000 ms, 2018-06-16T23:50:00, 63374, 60690, 124064, 24,light-sirt-1-1-4-100
1529211060000 ms, 2018-06-16T23:51:00, 64066, 63988, 128054, 24,light-sirt-1-1-4-100
1529211120000 ms, 2018-06-16T23:52:00, 68055, 63088, 131143, 24,light-sirt-1-1-4-100
1529211180000 ms, 2018-06-16T23:53:00, 71143, 60795, 131938, 24,light-sirt-1-1-4-100
1529211420000 ms, 2018-06-16T23:57:00, 4, 62686, 62690, 24,light-sirt-1-1-8-100
1529211480000 ms, 2018-06-16T23:58:00, 2746, 62596, 65342, 24,light-sirt-1-1-8-100
1529211540000 ms, 2018-06-16T23:59:00, 5345, 61972, 67317, 24,light-sirt-1-1-8-100
1529211600000 ms, 2018-06-17T00:00:00, 7317, 121581, 128898, 48,light-sirt-1-1-8-100
1529211660000 ms, 2018-06-17T00:01:00, 68899, 59819, 128718, 24,light-sirt-1-1-8-100
1529211720000 ms, 2018-06-17T00:02:00, 68719, 62366, 131085, 24,light-sirt-1-1-8-100
1529211960000 ms, 2018-06-17T00:06:00, 4, 121876, 121880, 48,light-sirt-1-1-16-100
1529212020000 ms, 2018-06-17T00:07:00, 61934, 62549, 124483, 24,light-sirt-1-1-16-100
1529212080000 ms, 2018-06-17T00:08:00, 64485, 122061, 186546, 48,light-sirt-1-1-16-100
1529212140000 ms, 2018-06-17T00:09:00, 126551, 63475, 190026, 24,light-sirt-1-1-16-100
1529212440000 ms, 2018-06-17T00:14:00, 5, 63129, 63134, 24,light-sirt-1-2-1-100
1529212500000 ms, 2018-06-17T00:15:00, 3186, 60291, 63477, 24,light-sirt-1-2-1-100
1529212560000 ms, 2018-06-17T00:16:00, 3480, 119864, 123344, 48,light-sirt-1-2-1-100
1529212620000 ms, 2018-06-17T00:17:00, 63342, 61017, 124359, 24,light-sirt-1-2-1-100
1529212680000 ms, 2018-06-17T00:18:00, 64363, 60787, 125150, 24,light-sirt-1-2-1-100
1529212740000 ms, 2018-06-17T00:19:00, 65150, 60107, 125257, 24,light-sirt-1-2-1-100
1529212980000 ms, 2018-06-17T00:23:00, 5, 63022, 63027, 24,light-sirt-1-2-2-100
1529213040000 ms, 2018-06-17T00:24:00, 3084, 119981, 123065, 48,light-sirt-1-2-2-100
1529213100000 ms, 2018-06-17T00:25:00, 63068, 61217, 124285, 24,light-sirt-1-2-2-100
1529213160000 ms, 2018-06-17T00:26:00, 64286, 61104, 125390, 24,light-sirt-1-2-2-100
1529213220000 ms, 2018-06-17T00:27:00, 65392, 119964, 185356, 48,light-sirt-1-2-2-100
1529213280000 ms, 2018-06-17T00:28:00, 125356, 132, 125488, 0,light-sirt-1-2-2-100
1529213460000 ms, 2018-06-17T00:31:00, 5, 62855, 62860, 24,light-sirt-1-2-4-100
1529213520000 ms, 2018-06-17T00:32:00, 2913, 63201, 66114, 24,light-sirt-1-2-4-100
1529213580000 ms, 2018-06-17T00:33:00, 6115, 61009, 67124, 24,light-sirt-1-2-4-100
1529213640000 ms, 2018-06-17T00:34:00, 7125, 60198, 67323, 24,light-sirt-1-2-4-100
1529213700000 ms, 2018-06-17T00:35:00, 7326, 118819, 126145, 48,light-sirt-1-2-4-100
1529213760000 ms, 2018-06-17T00:36:00, 66142, 62462, 128604, 24,light-sirt-1-2-4-100
1529214000000 ms, 2018-06-17T00:40:00, 4, 62709, 62713, 24,light-sirt-1-2-8-100
1529214060000 ms, 2018-06-17T00:41:00, 2767, 62294, 65061, 24,light-sirt-1-2-8-100
1529214120000 ms, 2018-06-17T00:42:00, 5061, 62927, 67988, 24,light-sirt-1-2-8-100
1529214180000 ms, 2018-06-17T00:43:00, 7989, 119158, 127147, 48,light-sirt-1-2-8-100
1529214240000 ms, 2018-06-17T00:44:00, 67150, 62778, 129928, 24,light-sirt-1-2-8-100
1529214300000 ms, 2018-06-17T00:45:00, 69928, 60751, 130679, 24,light-sirt-1-2-8-100
1529214540000 ms, 2018-06-17T00:49:00, 4, 63049, 63053, 24,light-sirt-1-2-16-100
1529214600000 ms, 2018-06-17T00:50:00, 3108, 120490, 123598, 48,light-sirt-1-2-16-100
1529214660000 ms, 2018-06-17T00:51:00, 63600, 62842, 126442, 24,light-sirt-1-2-16-100
1529214720000 ms, 2018-06-17T00:52:00, 66441, 60748, 127189, 24,light-sirt-1-2-16-100
1529214780000 ms, 2018-06-17T00:53:00, 67191, 61866, 129057, 24,light-sirt-1-2-16-100
1529215080000 ms, 2018-06-17T00:58:00, 4, 62977, 62981, 24,light-sirt-1-4-1-100
1529215140000 ms, 2018-06-17T00:59:00, 3035, 60760, 63795, 24,light-sirt-1-4-1-100
1529215200000 ms, 2018-06-17T01:00:00, 3798, 120196, 123994, 48,light-sirt-1-4-1-100
1529215260000 ms, 2018-06-17T01:01:00, 63996, 60969, 124965, 24,light-sirt-1-4-1-100
1529215320000 ms, 2018-06-17T01:02:00, 64956, 61027, 125983, 24,light-sirt-1-4-1-100
1529215380000 ms, 2018-06-17T01:03:00, 65992, 61139, 127131, 24,light-sirt-1-4-1-100
1529215620000 ms, 2018-06-17T01:07:00, 4, 122272, 122276, 48,light-sirt-1-4-2-100
1529215680000 ms, 2018-06-17T01:08:00, 62331, 60717, 123048, 24,light-sirt-1-4-2-100
1529215740000 ms, 2018-06-17T01:09:00, 63048, 62703, 125751, 24,light-sirt-1-4-2-100
1529215800000 ms, 2018-06-17T01:10:00, 65752, 119313, 185065, 48,light-sirt-1-4-2-100
1529216100000 ms, 2018-06-17T01:15:00, 4, 120761, 120765, 48,light-sirt-1-4-4-100
1529216160000 ms, 2018-06-17T01:16:00, 60818, 60944, 121762, 24,light-sirt-1-4-4-100
1529216220000 ms, 2018-06-17T01:17:00, 61763, 60994, 122757, 24,light-sirt-1-4-4-100
1529216280000 ms, 2018-06-17T01:18:00, 62757, 60183, 122940, 24,light-sirt-1-4-4-100
1529216580000 ms, 2018-06-17T01:23:00, 4, 62652, 62656, 24,light-sirt-1-4-8-100
1529216640000 ms, 2018-06-17T01:24:00, 2710, 62273, 64983, 24,light-sirt-1-4-8-100
1529216700000 ms, 2018-06-17T01:25:00, 4981, 121653, 126634, 48,light-sirt-1-4-8-100
1529216760000 ms, 2018-06-17T01:26:00, 66637, 60776, 127413, 24,light-sirt-1-4-8-100
1529216820000 ms, 2018-06-17T01:27:00, 67415, 61763, 129178, 24,light-sirt-1-4-8-100
1529216880000 ms, 2018-06-17T01:28:00, 69177, 62253, 131430, 24,light-sirt-1-4-8-100
1529217120000 ms, 2018-06-17T01:32:00, 4, 62892, 62896, 24,light-sirt-1-4-16-100
1529217180000 ms, 2018-06-17T01:33:00, 2951, 61852, 64803, 24,light-sirt-1-4-16-100
1529217240000 ms, 2018-06-17T01:34:00, 4802, 119724, 124526, 48,light-sirt-1-4-16-100
1529217300000 ms, 2018-06-17T01:35:00, 64531, 62598, 127129, 24,light-sirt-1-4-16-100
1529217360000 ms, 2018-06-17T01:36:00, 67125, 62817, 129942, 24,light-sirt-1-4-16-100
1529217420000 ms, 2018-06-17T01:37:00, 69939, 62057, 131996, 24,light-sirt-1-4-16-100
1529217720000 ms, 2018-06-17T01:42:00, 5, 64055, 64060, 24,light-sirt-2-1-1-100
1529217780000 ms, 2018-06-17T01:43:00, 4115, 119536, 123651, 48,light-sirt-2-1-1-100
1529217840000 ms, 2018-06-17T01:44:00, 63651, 60909, 124560, 24,light-sirt-2-1-1-100
1529217900000 ms, 2018-06-17T01:45:00, 64563, 60795, 125358, 24,light-sirt-2-1-1-100
1529218200000 ms, 2018-06-17T01:50:00, 5, 64119, 64124, 24,light-sirt-2-1-2-100
1529218260000 ms, 2018-06-17T01:51:00, 4178, 62729, 66907, 24,light-sirt-2-1-2-100
1529218320000 ms, 2018-06-17T01:52:00, 6909, 121219, 128128, 48,light-sirt-2-1-2-100
1529218380000 ms, 2018-06-17T01:53:00, 68127, 61459, 129586, 24,light-sirt-2-1-2-100
1529218440000 ms, 2018-06-17T01:54:00, 69587, 61027, 130614, 24,light-sirt-2-1-2-100
1529218500000 ms, 2018-06-17T01:55:00, 70614, 61750, 132364, 24,light-sirt-2-1-2-100
1529218680000 ms, 2018-06-17T01:58:00, 4, 62406, 62410, 24,light-sirt-2-1-4-100
1529218740000 ms, 2018-06-17T01:59:00, 2466, 60292, 62758, 24,light-sirt-2-1-4-100
1529218800000 ms, 2018-06-17T02:00:00, 2760, 64946, 67706, 24,light-sirt-2-1-4-100
1529218860000 ms, 2018-06-17T02:01:00, 7707, 122594, 130301, 48,light-sirt-2-1-4-100
1529218920000 ms, 2018-06-17T02:02:00, 70306, 62470, 132776, 24,light-sirt-2-1-4-100
1529218980000 ms, 2018-06-17T02:03:00, 72775, 60660, 133435, 24,light-sirt-2-1-4-100
1529219220000 ms, 2018-06-17T02:07:00, 5, 121286, 121291, 48,light-sirt-2-1-8-100
1529219280000 ms, 2018-06-17T02:08:00, 61348, 61014, 122362, 24,light-sirt-2-1-8-100
1529219340000 ms, 2018-06-17T02:09:00, 62364, 120105, 182469, 48,light-sirt-2-1-8-100
1529219400000 ms, 2018-06-17T02:10:00, 122473, 60746, 183219, 24,light-sirt-2-1-8-100
1529219700000 ms, 2018-06-17T02:15:00, 4, 62901, 62905, 24,light-sirt-2-1-16-100
1529219760000 ms, 2018-06-17T02:16:00, 2954, 121810, 124764, 48,light-sirt-2-1-16-100
1529219820000 ms, 2018-06-17T02:17:00, 64769, 62550, 127319, 24,light-sirt-2-1-16-100
1529219880000 ms, 2018-06-17T02:18:00, 67322, 62562, 129884, 24,light-sirt-2-1-16-100
1529220240000 ms, 2018-06-17T02:24:00, 4, 65542, 65546, 24,light-sirt-2-2-1-100
1529220300000 ms, 2018-06-17T02:25:00, 5604, 122402, 128006, 48,light-sirt-2-2-1-100
1529220360000 ms, 2018-06-17T02:26:00, 68005, 62676, 130681, 24,light-sirt-2-2-1-100
1529220420000 ms, 2018-06-17T02:27:00, 70684, 62246, 132930, 24,light-sirt-2-2-1-100
1529220720000 ms, 2018-06-17T02:32:00, 4, 62597, 62601, 24,light-sirt-2-2-2-100
1529220780000 ms, 2018-06-17T02:33:00, 2657, 60609, 63266, 24,light-sirt-2-2-2-100
1529220840000 ms, 2018-06-17T02:34:00, 3269, 119427, 122696, 48,light-sirt-2-2-2-100
1529220900000 ms, 2018-06-17T02:35:00, 62695, 62205, 124900, 24,light-sirt-2-2-2-100
1529220960000 ms, 2018-06-17T02:36:00, 64905, 60762, 125667, 24,light-sirt-2-2-2-100
1529221200000 ms, 2018-06-17T02:40:00, 4, 62697, 62701, 24,light-sirt-2-2-4-100
1529221260000 ms, 2018-06-17T02:41:00, 2753, 62570, 65323, 24,light-sirt-2-2-4-100
1529221320000 ms, 2018-06-17T02:42:00, 5324, 60134, 65458, 24,light-sirt-2-2-4-100
1529221380000 ms, 2018-06-17T02:43:00, 5458, 117660, 123118, 48,light-sirt-2-2-4-100
1529221440000 ms, 2018-06-17T02:44:00, 63120, 62315, 125435, 24,light-sirt-2-2-4-100
1529221500000 ms, 2018-06-17T02:45:00, 65434, 60537, 125971, 24,light-sirt-2-2-4-100
1529221740000 ms, 2018-06-17T02:49:00, 4, 119041, 119045, 48,light-sirt-2-2-8-100
1529221800000 ms, 2018-06-17T02:50:00, 59102, 62001, 121103, 24,light-sirt-2-2-8-100
1529221860000 ms, 2018-06-17T02:51:00, 61105, 59167, 120272, 24,light-sirt-2-2-8-100
1529222220000 ms, 2018-06-17T02:57:00, 4, 62448, 62452, 24,light-sirt-2-2-16-100
1529222280000 ms, 2018-06-17T02:58:00, 2511, 120994, 123505, 48,light-sirt-2-2-16-100
1529222340000 ms, 2018-06-17T02:59:00, 63507, 62472, 125979, 24,light-sirt-2-2-16-100
1529222400000 ms, 2018-06-17T03:00:00, 65978, 62701, 128679, 24,light-sirt-2-2-16-100
1529222760000 ms, 2018-06-17T03:06:00, 4, 63562, 63566, 24,light-sirt-2-4-1-100
1529222820000 ms, 2018-06-17T03:07:00, 3634, 120802, 124436, 48,light-sirt-2-4-1-100
1529222880000 ms, 2018-06-17T03:08:00, 64437, 60667, 125104, 24,light-sirt-2-4-1-100
1529222940000 ms, 2018-06-17T03:09:00, 65091, 60741, 125832, 24,light-sirt-2-4-1-100
1529223000000 ms, 2018-06-17T03:10:00, 65847, 60663, 126510, 24,light-sirt-2-4-1-100
1529223240000 ms, 2018-06-17T03:14:00, 5, 62996, 63001, 24,light-sirt-2-4-2-100
1529223300000 ms, 2018-06-17T03:15:00, 3060, 60365, 63425, 24,light-sirt-2-4-2-100
1529223360000 ms, 2018-06-17T03:16:00, 3426, 119764, 123190, 48,light-sirt-2-4-2-100
1529223420000 ms, 2018-06-17T03:17:00, 63193, 62447, 125640, 24,light-sirt-2-4-2-100
1529223480000 ms, 2018-06-17T03:18:00, 65641, 60187, 125828, 24,light-sirt-2-4-2-100
1529223720000 ms, 2018-06-17T03:22:00, 4, 62842, 62846, 24,light-sirt-2-4-4-100
1529223780000 ms, 2018-06-17T03:23:00, 2901, 63350, 66251, 24,light-sirt-2-4-4-100
1529223840000 ms, 2018-06-17T03:24:00, 6252, 120432, 126684, 48,light-sirt-2-4-4-100
1529223900000 ms, 2018-06-17T03:25:00, 66686, 60409, 127095, 24,light-sirt-2-4-4-100
1529223960000 ms, 2018-06-17T03:26:00, 67095, 60720, 127815, 24,light-sirt-2-4-4-100
1529224020000 ms, 2018-06-17T03:27:00, 67812, 60496, 128308, 24,light-sirt-2-4-4-100
1529224260000 ms, 2018-06-17T03:31:00, 4, 120746, 120750, 48,light-sirt-2-4-8-100
1529224320000 ms, 2018-06-17T03:32:00, 60804, 64484, 125288, 24,light-sirt-2-4-8-100
1529224380000 ms, 2018-06-17T03:33:00, 65293, 121489, 186782, 48,light-sirt-2-4-8-100
1529224440000 ms, 2018-06-17T03:34:00, 126781, 62949, 189730, 24,light-sirt-2-4-8-100
1529224740000 ms, 2018-06-17T03:39:00, 4, 62726, 62730, 24,light-sirt-2-4-16-100
1529224800000 ms, 2018-06-17T03:40:00, 2786, 121640, 124426, 48,light-sirt-2-4-16-100
1529224860000 ms, 2018-06-17T03:41:00, 64424, 62345, 126769, 24,light-sirt-2-4-16-100
1529224920000 ms, 2018-06-17T03:42:00, 66769, 62981, 129750, 24,light-sirt-2-4-16-100
1529225280000 ms, 2018-06-17T03:48:00, 5, 63011, 63016, 24,light-sirt-4-1-1-100
1529225340000 ms, 2018-06-17T03:49:00, 3074, 60680, 63754, 24,light-sirt-4-1-1-100
1529225400000 ms, 2018-06-17T03:50:00, 3758, 60516, 64274, 24,light-sirt-4-1-1-100
1529225460000 ms, 2018-06-17T03:51:00, 4271, 121371, 125642, 48,light-sirt-4-1-1-100
1529225520000 ms, 2018-06-17T03:52:00, 65646, 60155, 125801, 24,light-sirt-4-1-1-100
1529225580000 ms, 2018-06-17T03:53:00, 65800, 60778, 126578, 24,light-sirt-4-1-1-100
1529225820000 ms, 2018-06-17T03:57:00, 4, 126657, 126661, 48,light-sirt-4-1-2-100
1529225880000 ms, 2018-06-17T03:58:00, 66719, 62944, 129663, 24,light-sirt-4-1-2-100
1529225940000 ms, 2018-06-17T03:59:00, 69664, 122063, 191727, 48,light-sirt-4-1-2-100
1529226000000 ms, 2018-06-17T04:00:00, 131730, 62837, 194567, 24,light-sirt-4-1-2-100
1529226300000 ms, 2018-06-17T04:05:00, 4, 123665, 123669, 48,light-sirt-4-1-4-100
1529226360000 ms, 2018-06-17T04:06:00, 63726, 62411, 126137, 24,light-sirt-4-1-4-100
1529226420000 ms, 2018-06-17T04:07:00, 66139, 62671, 128810, 24,light-sirt-4-1-4-100
1529226480000 ms, 2018-06-17T04:08:00, 68811, 119990, 188801, 48,light-sirt-4-1-4-100
1529226780000 ms, 2018-06-17T04:13:00, 5, 62382, 62387, 24,light-sirt-4-1-8-100
1529226840000 ms, 2018-06-17T04:14:00, 2444, 120668, 123112, 48,light-sirt-4-1-8-100
1529226900000 ms, 2018-06-17T04:15:00, 63113, 61003, 124116, 24,light-sirt-4-1-8-100
1529226960000 ms, 2018-06-17T04:16:00, 64120, 62425, 126545, 24,light-sirt-4-1-8-100
1529227260000 ms, 2018-06-17T04:21:00, 4, 63204, 63208, 24,light-sirt-4-1-16-100
1529227320000 ms, 2018-06-17T04:22:00, 3265, 62591, 65856, 24,light-sirt-4-1-16-100
1529227380000 ms, 2018-06-17T04:23:00, 5856, 62846, 68702, 24,light-sirt-4-1-16-100
1529227440000 ms, 2018-06-17T04:24:00, 8702, 120347, 129049, 48,light-sirt-4-1-16-100
1529227500000 ms, 2018-06-17T04:25:00, 69051, 63280, 132331, 24,light-sirt-4-1-16-100
1529227560000 ms, 2018-06-17T04:26:00, 72331, 62857, 135188, 24,light-sirt-4-1-16-100
1529227860000 ms, 2018-06-17T04:31:00, 6, 121875, 121881, 48,light-sirt-4-2-1-100
1529227920000 ms, 2018-06-17T04:32:00, 61938, 60476, 122414, 24,light-sirt-4-2-1-100
1529227980000 ms, 2018-06-17T04:33:00, 62414, 60196, 122610, 24,light-sirt-4-2-1-100
1529228040000 ms, 2018-06-17T04:34:00, 62613, 119770, 182383, 48,light-sirt-4-2-1-100
1529228340000 ms, 2018-06-17T04:39:00, 4, 121239, 121243, 48,light-sirt-4-2-2-100
1529228400000 ms, 2018-06-17T04:40:00, 61301, 60485, 121786, 24,light-sirt-4-2-2-100
1529228460000 ms, 2018-06-17T04:41:00, 61787, 60026, 121813, 24,light-sirt-4-2-2-100
1529228520000 ms, 2018-06-17T04:42:00, 61813, 119488, 181301, 48,light-sirt-4-2-2-100
1529228820000 ms, 2018-06-17T04:47:00, 5, 64657, 64662, 24,light-sirt-4-2-4-100
1529228880000 ms, 2018-06-17T04:48:00, 4719, 123211, 127930, 48,light-sirt-4-2-4-100
1529228940000 ms, 2018-06-17T04:49:00, 67931, 62984, 130915, 24,light-sirt-4-2-4-100
1529229000000 ms, 2018-06-17T04:50:00, 70916, 62573, 133489, 24,light-sirt-4-2-4-100
1529229300000 ms, 2018-06-17T04:55:00, 4, 62544, 62548, 24,light-sirt-4-2-8-100
1529229360000 ms, 2018-06-17T04:56:00, 2601, 60325, 62926, 24,light-sirt-4-2-8-100
1529229420000 ms, 2018-06-17T04:57:00, 2929, 120702, 123631, 48,light-sirt-4-2-8-100
1529229480000 ms, 2018-06-17T04:58:00, 63629, 62625, 126254, 24,light-sirt-4-2-8-100
1529229540000 ms, 2018-06-17T04:59:00, 66257, 60479, 126736, 24,light-sirt-4-2-8-100
1529229840000 ms, 2018-06-17T05:04:00, 4, 120510, 120514, 48,light-sirt-4-2-16-100
1529229900000 ms, 2018-06-17T05:05:00, 60573, 62817, 123390, 24,light-sirt-4-2-16-100
1529229960000 ms, 2018-06-17T05:06:00, 63391, 62389, 125780, 24,light-sirt-4-2-16-100
1529230020000 ms, 2018-06-17T05:07:00, 65779, 122791, 188570, 48,light-sirt-4-2-16-100
1529230380000 ms, 2018-06-17T05:13:00, 4, 63468, 63472, 24,light-sirt-4-4-1-100
1529230440000 ms, 2018-06-17T05:14:00, 3543, 120499, 124042, 48,light-sirt-4-4-1-100
1529230500000 ms, 2018-06-17T05:15:00, 64041, 61019, 125060, 24,light-sirt-4-4-1-100
1529230560000 ms, 2018-06-17T05:16:00, 65060, 61216, 126276, 24,light-sirt-4-4-1-100
1529230860000 ms, 2018-06-17T05:21:00, 4, 63125, 63129, 24,light-sirt-4-4-2-100
1529230920000 ms, 2018-06-17T05:22:00, 3187, 60889, 64076, 24,light-sirt-4-4-2-100
1529230980000 ms, 2018-06-17T05:23:00, 4077, 122949, 127026, 48,light-sirt-4-4-2-100
1529231040000 ms, 2018-06-17T05:24:00, 67026, 61469, 128495, 24,light-sirt-4-4-2-100
1529231100000 ms, 2018-06-17T05:25:00, 68497, 61523, 130020, 24,light-sirt-4-4-2-100
1529231340000 ms, 2018-06-17T05:29:00, 4, 62798, 62802, 24,light-sirt-4-4-4-100
1529231400000 ms, 2018-06-17T05:30:00, 2865, 63200, 66065, 24,light-sirt-4-4-4-100
1529231460000 ms, 2018-06-17T05:31:00, 6066, 60315, 66381, 24,light-sirt-4-4-4-100
1529231520000 ms, 2018-06-17T05:32:00, 6382, 119532, 125914, 48,light-sirt-4-4-4-100
1529231580000 ms, 2018-06-17T05:33:00, 65915, 62386, 128301, 24,light-sirt-4-4-4-100
1529231640000 ms, 2018-06-17T05:34:00, 68298, 60760, 129058, 24,light-sirt-4-4-4-100
1529231880000 ms, 2018-06-17T05:38:00, 4, 62941, 62945, 24,light-sirt-4-4-8-100
1529231940000 ms, 2018-06-17T05:39:00, 2999, 119116, 122115, 48,light-sirt-4-4-8-100
1529232000000 ms, 2018-06-17T05:40:00, 62119, 63121, 125240, 24,light-sirt-4-4-8-100
1529232060000 ms, 2018-06-17T05:41:00, 65240, 61172, 126412, 24,light-sirt-4-4-8-100
1529232360000 ms, 2018-06-17T05:46:00, 5, 63275, 63280, 24,light-sirt-4-4-16-100
1529232420000 ms, 2018-06-17T05:47:00, 3336, 62887, 66223, 24,light-sirt-4-4-16-100
1529232480000 ms, 2018-06-17T05:48:00, 6228, 120634, 126862, 48,light-sirt-4-4-16-100
1529232540000 ms, 2018-06-17T05:49:00, 66863, 61599, 128462, 24,light-sirt-4-4-16-100
1529232960000 ms, 2018-06-17T05:56:00, 5, 62681, 62686, 24,light-sirt-8-1-1-100
1529233020000 ms, 2018-06-17T05:57:00, 2719, 60686, 63405, 24,light-sirt-8-1-1-100
1529233080000 ms, 2018-06-17T05:58:00, 3428, 119322, 122750, 48,light-sirt-8-1-1-100
1529233140000 ms, 2018-06-17T05:59:00, 62749, 61000, 123749, 24,light-sirt-8-1-1-100
1529233200000 ms, 2018-06-17T06:00:00, 63752, 60434, 124186, 24,light-sirt-8-1-1-100
1529233440000 ms, 2018-06-17T06:04:00, 5, 62869, 62874, 24,light-sirt-8-1-2-100
1529233500000 ms, 2018-06-17T06:05:00, 2932, 63189, 66121, 24,light-sirt-8-1-2-100
1529233560000 ms, 2018-06-17T06:06:00, 6122, 60830, 66952, 24,light-sirt-8-1-2-100
1529233620000 ms, 2018-06-17T06:07:00, 6950, 120818, 127768, 48,light-sirt-8-1-2-100
1529233680000 ms, 2018-06-17T06:08:00, 67773, 61001, 128774, 24,light-sirt-8-1-2-100
1529233740000 ms, 2018-06-17T06:09:00, 68771, 60867, 129638, 24,light-sirt-8-1-2-100
1529233980000 ms, 2018-06-17T06:13:00, 3, 121615, 121618, 48,light-sirt-8-1-4-100
1529234040000 ms, 2018-06-17T06:14:00, 61673, 62377, 124050, 24,light-sirt-8-1-4-100
1529234100000 ms, 2018-06-17T06:15:00, 64052, 87058, 151110, 34,light-sirt-8-1-4-100
1529234160000 ms, 2018-06-17T06:16:00, 91112, 96301, 187413, 38,light-sirt-8-1-4-100
1529234460000 ms, 2018-06-17T06:21:00, 5, 122373, 122378, 48,light-sirt-8-1-8-100
1529234520000 ms, 2018-06-17T06:22:00, 62441, 62638, 125079, 24,light-sirt-8-1-8-100
1529234580000 ms, 2018-06-17T06:23:00, 65080, 61184, 126264, 24,light-sirt-8-1-8-100
1529234640000 ms, 2018-06-17T06:24:00, 66263, 120431, 186694, 48,light-sirt-8-1-8-100
1529234940000 ms, 2018-06-17T06:29:00, 4, 62932, 62936, 24,light-sirt-8-1-16-100
1529235000000 ms, 2018-06-17T06:30:00, 2990, 120750, 123740, 48,light-sirt-8-1-16-100
1529235060000 ms, 2018-06-17T06:31:00, 63743, 62752, 126495, 24,light-sirt-8-1-16-100
1529235120000 ms, 2018-06-17T06:32:00, 66497, 61795, 128292, 24,light-sirt-8-1-16-100
1529235180000 ms, 2018-06-17T06:33:00, 68292, 61962, 130254, 24,light-sirt-8-1-16-100
1529235540000 ms, 2018-06-17T06:39:00, 4, 122245, 122249, 48,light-sirt-8-2-1-100
1529235600000 ms, 2018-06-17T06:40:00, 62304, 60517, 122821, 24,light-sirt-8-2-1-100
1529235660000 ms, 2018-06-17T06:41:00, 62824, 61097, 123921, 24,light-sirt-8-2-1-100
1529235720000 ms, 2018-06-17T06:42:00, 63920, 118842, 182762, 48,light-sirt-8-2-1-100
1529236020000 ms, 2018-06-17T06:47:00, 5, 63173, 63178, 24,light-sirt-8-2-2-100
1529236080000 ms, 2018-06-17T06:48:00, 3235, 120929, 124164, 48,light-sirt-8-2-2-100
1529236140000 ms, 2018-06-17T06:49:00, 64165, 61057, 125222, 24,light-sirt-8-2-2-100
1529236200000 ms, 2018-06-17T06:50:00, 65222, 60558, 125780, 24,light-sirt-8-2-2-100
1529236500000 ms, 2018-06-17T06:55:00, 5, 62718, 62723, 24,light-sirt-8-2-4-100
1529236560000 ms, 2018-06-17T06:56:00, 2784, 61488, 64272, 24,light-sirt-8-2-4-100
1529236620000 ms, 2018-06-17T06:57:00, 4273, 120017, 124290, 48,light-sirt-8-2-4-100
1529236680000 ms, 2018-06-17T06:58:00, 64289, 62543, 126832, 24,light-sirt-8-2-4-100
1529236740000 ms, 2018-06-17T06:59:00, 66835, 60931, 127766, 24,light-sirt-8-2-4-100
1529236980000 ms, 2018-06-17T07:03:00, 4, 62762, 62766, 24,light-sirt-8-2-8-100
1529237040000 ms, 2018-06-17T07:04:00, 2821, 60915, 63736, 24,light-sirt-8-2-8-100
1529237100000 ms, 2018-06-17T07:05:00, 3736, 61495, 65231, 24,light-sirt-8-2-8-100
1529237160000 ms, 2018-06-17T07:06:00, 5231, 121630, 126861, 48,light-sirt-8-2-8-100
1529237220000 ms, 2018-06-17T07:07:00, 66866, 58785, 125651, 24,light-sirt-8-2-8-100
1529237280000 ms, 2018-06-17T07:08:00, 65649, 60168, 125817, 24,light-sirt-8-2-8-100
1529237520000 ms, 2018-06-17T07:12:00, 4, 122407, 122411, 48,light-sirt-8-2-16-100
1529237580000 ms, 2018-06-17T07:13:00, 62468, 63012, 125480, 24,light-sirt-8-2-16-100
1529237640000 ms, 2018-06-17T07:14:00, 65483, 63279, 128762, 24,light-sirt-8-2-16-100
1529237700000 ms, 2018-06-17T07:15:00, 68759, 121997, 190756, 48,light-sirt-8-2-16-100
1529238060000 ms, 2018-06-17T07:21:00, 5, 62643, 62648, 24,light-sirt-8-4-1-100
1529238120000 ms, 2018-06-17T07:22:00, 2589, 61250, 63839, 24,light-sirt-8-4-1-100
1529238180000 ms, 2018-06-17T07:23:00, 3943, 60969, 64912, 24,light-sirt-8-4-1-100
1529238240000 ms, 2018-06-17T07:24:00, 4923, 120850, 125773, 48,light-sirt-8-4-1-100
1529238300000 ms, 2018-06-17T07:25:00, 65772, 60764, 126536, 24,light-sirt-8-4-1-100
1529238360000 ms, 2018-06-17T07:26:00, 66532, 60623, 127155, 24,light-sirt-8-4-1-100
1529238600000 ms, 2018-06-17T07:30:00, 4, 120084, 120088, 48,light-sirt-8-4-2-100
1529238660000 ms, 2018-06-17T07:31:00, 60146, 60527, 120673, 24,light-sirt-8-4-2-100
1529238720000 ms, 2018-06-17T07:32:00, 60674, 61151, 121825, 24,light-sirt-8-4-2-100
1529238780000 ms, 2018-06-17T07:33:00, 61823, 118013, 179836, 48,light-sirt-8-4-2-100
1529239080000 ms, 2018-06-17T07:38:00, 4, 123940, 123944, 48,light-sirt-8-4-4-100
1529239140000 ms, 2018-06-17T07:39:00, 64000, 61531, 125531, 24,light-sirt-8-4-4-100
1529239200000 ms, 2018-06-17T07:40:00, 65534, 62444, 127978, 24,light-sirt-8-4-4-100
1529239260000 ms, 2018-06-17T07:41:00, 67975, 121226, 189201, 48,light-sirt-8-4-4-100
1529239560000 ms, 2018-06-17T07:46:00, 4, 63155, 63159, 24,light-sirt-8-4-8-100
1529239620000 ms, 2018-06-17T07:47:00, 3218, 119040, 122258, 48,light-sirt-8-4-8-100
1529239680000 ms, 2018-06-17T07:48:00, 62258, 62702, 124960, 24,light-sirt-8-4-8-100
1529239740000 ms, 2018-06-17T07:49:00, 64961, 62063, 127024, 24,light-sirt-8-4-8-100
1529269860000 ms, 2018-06-17T16:11:00, 4, 121688, 121692, 48,light-sirt-16-1-1-100
1529269920000 ms, 2018-06-17T16:12:00, 61744, 120037, 181781, 48,light-sirt-16-1-1-100
1529269980000 ms, 2018-06-17T16:13:00, 121783, 60789, 182572, 24,light-sirt-16-1-1-100
1529270040000 ms, 2018-06-17T16:14:00, 122574, 87821, 210395, 35,light-sirt-16-1-1-100
1529270100000 ms, 2018-06-17T16:15:00, 150393, 92669, 243062, 37,light-sirt-16-1-1-100
1529270160000 ms, 2018-06-17T16:16:00, 183065, 60688, 243753, 24,light-sirt-16-1-1-100
1529270460000 ms, 2018-06-17T16:21:00, 5, 62157, 62162, 24,light-sirt-16-1-2-100
1529270520000 ms, 2018-06-17T16:22:00, 2220, 119051, 121271, 48,light-sirt-16-1-2-100
1529270580000 ms, 2018-06-17T16:23:00, 61273, 60334, 121607, 24,light-sirt-16-1-2-100
1529270640000 ms, 2018-06-17T16:24:00, 61609, 120725, 182334, 48,light-sirt-16-1-2-100
1529270700000 ms, 2018-06-17T16:25:00, 122332, 60217, 182549, 24,light-sirt-16-1-2-100
1529270760000 ms, 2018-06-17T16:26:00, 122551, 120459, 243010, 48,light-sirt-16-1-2-100
1529271120000 ms, 2018-06-17T16:32:00, 4, 121974, 121978, 48,light-sirt-16-1-4-100
1529271180000 ms, 2018-06-17T16:33:00, 62030, 62514, 124544, 24,light-sirt-16-1-4-100
1529271240000 ms, 2018-06-17T16:34:00, 64546, 118763, 183309, 48,light-sirt-16-1-4-100
1529271300000 ms, 2018-06-17T16:35:00, 123309, 62686, 185995, 24,light-sirt-16-1-4-100
1529271360000 ms, 2018-06-17T16:36:00, 125997, 118675, 244672, 48,light-sirt-16-1-4-100
1529271420000 ms, 2018-06-17T16:37:00, 184673, 60408, 245081, 24,light-sirt-16-1-4-100
1529271720000 ms, 2018-06-17T16:42:00, 3, 62968, 62971, 24,light-sirt-16-1-8-100
1529271780000 ms, 2018-06-17T16:43:00, 3021, 62823, 65844, 24,light-sirt-16-1-8-100
1529271840000 ms, 2018-06-17T16:44:00, 5846, 122636, 128482, 48,light-sirt-16-1-8-100
1529271900000 ms, 2018-06-17T16:45:00, 68483, 62632, 131115, 24,light-sirt-16-1-8-100
1529271960000 ms, 2018-06-17T16:46:00, 71117, 123333, 194450, 48,light-sirt-16-1-8-100
1529272020000 ms, 2018-06-17T16:47:00, 134450, 62911, 197361, 24,light-sirt-16-1-8-100
1529272620000 ms, 2018-06-17T16:57:00, 4, 62767, 62771, 24,light-sirt-16-1-16-100
1529272680000 ms, 2018-06-17T16:58:00, 2821, 121851, 124672, 48,light-sirt-16-1-16-100
1529272740000 ms, 2018-06-17T16:59:00, 64673, 62402, 127075, 24,light-sirt-16-1-16-100
1529272800000 ms, 2018-06-17T17:00:00, 67078, 122232, 189310, 48,light-sirt-16-1-16-100
1529272860000 ms, 2018-06-17T17:01:00, 129309, 62192, 191501, 24,light-sirt-16-1-16-100
1529273340000 ms, 2018-06-17T17:09:00, 4, 62820, 62824, 24,light-sirt-16-2-1-100
1529273400000 ms, 2018-06-17T17:10:00, 2875, 60772, 63647, 24,light-sirt-16-2-1-100
1529273460000 ms, 2018-06-17T17:11:00, 3648, 119433, 123081, 48,light-sirt-16-2-1-100
1529273520000 ms, 2018-06-17T17:12:00, 63082, 61406, 124488, 24,light-sirt-16-2-1-100
1529273580000 ms, 2018-06-17T17:13:00, 64493, 119407, 183900, 48,light-sirt-16-2-1-100
1529274000000 ms, 2018-06-17T17:20:00, 4, 62460, 62464, 24,light-sirt-16-2-2-100
1529274060000 ms, 2018-06-17T17:21:00, 2519, 120994, 123513, 48,light-sirt-16-2-2-100
1529274120000 ms, 2018-06-17T17:22:00, 63514, 60484, 123998, 24,light-sirt-16-2-2-100
1529274180000 ms, 2018-06-17T17:23:00, 63997, 119650, 183647, 48,light-sirt-16-2-2-100
1529274240000 ms, 2018-06-17T17:24:00, 123650, 60698, 184348, 24,light-sirt-16-2-2-100
1529274300000 ms, 2018-06-17T17:25:00, 124348, 119014, 243362, 48,light-sirt-16-2-2-100
1529274660000 ms, 2018-06-17T17:31:00, 4, 122058, 122062, 48,light-sirt-16-2-4-100
1529274720000 ms, 2018-06-17T17:32:00, 62116, 60429, 122545, 24,light-sirt-16-2-4-100
1529274780000 ms, 2018-06-17T17:33:00, 62547, 121496, 184043, 48,light-sirt-16-2-4-100
1529274840000 ms, 2018-06-17T17:34:00, 124043, 60754, 184797, 24,light-sirt-16-2-4-100
1529274900000 ms, 2018-06-17T17:35:00, 124801, 119067, 243868, 48,light-sirt-16-2-4-100
1529274960000 ms, 2018-06-17T17:36:00, 183864, 60728, 244592, 24,light-sirt-16-2-4-100
1529275260000 ms, 2018-06-17T17:41:00, 4, 63167, 63171, 24,light-sirt-16-2-8-100
1529275320000 ms, 2018-06-17T17:42:00, 3220, 62689, 65909, 24,light-sirt-16-2-8-100
1529275380000 ms, 2018-06-17T17:43:00, 5912, 121529, 127441, 48,light-sirt-16-2-8-100
1529275440000 ms, 2018-06-17T17:44:00, 67442, 60489, 127931, 24,light-sirt-16-2-8-100
1529275500000 ms, 2018-06-17T17:45:00, 67933, 121456, 189389, 48,light-sirt-16-2-8-100
1529275560000 ms, 2018-06-17T17:46:00, 129389, 60786, 190175, 24,light-sirt-16-2-8-100
1529281920000 ms, 2018-06-17T19:32:00, 5, 121514, 121519, 48,light-sirt-16-4-1-100
1529281980000 ms, 2018-06-17T19:33:00, 61573, 119643, 181216, 48,light-sirt-16-4-1-100
1529282040000 ms, 2018-06-17T19:34:00, 121226, 60277, 181503, 24,light-sirt-16-4-1-100
1529282100000 ms, 2018-06-17T19:35:00, 121505, 118956, 240461, 48,light-sirt-16-4-1-100
1529282160000 ms, 2018-06-17T19:36:00, 180462, 60757, 241219, 24,light-sirt-16-4-1-100
1529282520000 ms, 2018-06-17T19:42:00, 5, 62810, 62815, 24,light-sirt-16-4-2-100
1529282580000 ms, 2018-06-17T19:43:00, 2874, 120916, 123790, 48,light-sirt-16-4-2-100
1529282640000 ms, 2018-06-17T19:44:00, 63788, 60238, 124026, 24,light-sirt-16-4-2-100
1529282700000 ms, 2018-06-17T19:45:00, 64027, 120348, 184375, 48,light-sirt-16-4-2-100
1529282760000 ms, 2018-06-17T19:46:00, 124378, 60495, 184873, 24,light-sirt-16-4-2-100
1529282820000 ms, 2018-06-17T19:47:00, 124871, 119852, 244723, 48,light-sirt-16-4-2-100
1529283180000 ms, 2018-06-17T19:53:00, 4, 120807, 120811, 48,light-sirt-16-4-4-100
1529283240000 ms, 2018-06-17T19:54:00, 60865, 62282, 123147, 24,light-sirt-16-4-4-100
1529283300000 ms, 2018-06-17T19:55:00, 63148, 120215, 183363, 48,light-sirt-16-4-4-100
1529283360000 ms, 2018-06-17T19:56:00, 123362, 62874, 186236, 24,light-sirt-16-4-4-100
1529283420000 ms, 2018-06-17T19:57:00, 126236, 120966, 247202, 48,light-sirt-16-4-4-100
1529283480000 ms, 2018-06-17T19:58:00, 187208, 60515, 247723, 24,light-sirt-16-4-4-100
1529283780000 ms, 2018-06-17T20:03:00, 5, 63224, 63229, 24,light-sirt-16-4-8-100
1529283840000 ms, 2018-06-17T20:04:00, 3283, 62327, 65610, 24,light-sirt-16-4-8-100
1529283900000 ms, 2018-06-17T20:05:00, 5610, 120844, 126454, 48,light-sirt-16-4-8-100
1529283960000 ms, 2018-06-17T20:06:00, 66456, 62975, 129431, 24,light-sirt-16-4-8-100
1529284020000 ms, 2018-06-17T20:07:00, 69432, 121779, 191211, 48,light-sirt-16-4-8-100
1529284080000 ms, 2018-06-17T20:08:00, 131209, 62107, 193316, 24,light-sirt-16-4-8-100
1529286420000 ms, 2018-06-17T20:47:00, 4, 61167, 61171, 24,light-sirt-16-2-16-100
1529286480000 ms, 2018-06-17T20:48:00, 1217, 59149, 60366, 24,light-sirt-16-2-16-100
1529286540000 ms, 2018-06-17T20:49:00, 374, 121760, 122134, 48,light-sirt-16-2-16-100
1529286600000 ms, 2018-06-17T20:50:00, 62135, 62651, 124786, 24,light-sirt-16-2-16-100
1529286660000 ms, 2018-06-17T20:51:00, 64787, 122629, 187416, 48,light-sirt-16-2-16-100
1529286720000 ms, 2018-06-17T20:52:00, 127411, 60871, 188282, 24,light-sirt-16-2-16-100
1529287200000 ms, 2018-06-17T21:00:00, 4, 120752, 120756, 48,light-sirt-8-4-16-100
1529287260000 ms, 2018-06-17T21:01:00, 60814, 62732, 123546, 24,light-sirt-8-4-16-100
1529287320000 ms, 2018-06-17T21:02:00, 63542, 119702, 183244, 48,light-sirt-8-4-16-100
1529287380000 ms, 2018-06-17T21:03:00, 123250, 61023, 184273, 24,light-sirt-8-4-16-100
1529287440000 ms, 2018-06-17T21:04:00, 124278, 120174, 244452, 48,light-sirt-8-4-16-100
1529287500000 ms, 2018-06-17T21:05:00, 184454, 60614, 245068, 24,light-sirt-8-4-16-100
